%%%%%%%%%%%%%%
%           G%
%        %%  %
%         %  %
%            %
%            %
%            %
%S           %
%%%%%%%%%%%%%%