%%%%%%%%%%%%%%
%           G%
% %%%%%%%%%  %
%         %  %
%         %  %
%         %  %
%         %  %
%S           %
%%%%%%%%%%%%%%