%%%%%%%%%%%%%%
%    S       %
%   %%%      %
%   %   %    %
%       %    %
%G        %  %
%         %  %
%            %
%%%%%%%%%%%%%%