%%%%%%%%%%
%G      S%
%%%%%%%%%%
