%%%%%%%
%    S%
% %%% %
%  %  %
%%   %%
%G %%%%
%%%%%%%
