%%%%%%%%%%
%%%S     %
%%% %%%% %
%%%G     %
%%%%%%%%%%